21100000000000000000
01011110010010101000
01000101010101000100
01000101000011011100
11011111100101000100
11000001000101000100
01000110111111010110
01000100011011000110
11011111100101000100
10000000010011111100
01000000010011110100
11011111100101000000
01010111111111101000
00010100010101101010
00010100000100100010
01010100100111110010
00010111000101111010
00010101111111110000
01010011110101000000
01000000000000000003
