21100000000000000000
01111110010010101000
01000101010101000100
01100101000011011100
11111111100101000100
11100001000101000100
01100110111111010110
01100100011011000110
11111111100101000100
10100000010011111100
01100000010011110100
11111111100101000000
01110111111111101000
00110100010101101010
00110100000100100010
01110100100111110010
00110111000101111010
00110101111111110000
01110011110101000000
01111011011111111113
